22 12
6 5 5 6 6 5 5 5 5 5 5 5 5 5 5 5 5 7 7 5 5 5
1 0 0 0 0 0 0 0 0 0 0 2 5 5 5 5 5 5 5 5 5 6
5 5 5 5 5 5 5 8 5 5 5 0 5 5 5 5 5 8 5 5 5 5
5 5 5 5 5 5 5 5 5 5 5 0 8 5 5 5 5 5 5 5 5 6
5 5 5 5 7 7 8 5 5 5 5 0 5 5 5 6 5 5 6 6 5 5
5 8 5 5 5 5 5 5 5 5 5 0 5 5 5 5 5 5 5 5 5 5
5 5 5 5 6 6 5 5 5 5 5 0 5 5 5 5 5 5 5 5 7 7
5 5 5 5 5 5 5 5 5 5 5 0 5 5 5 6 5 5 5 5 5 5
5 5 8 5 6 5 7 5 5 5 5 0 5 5 5 6 5 5 5 8 5 7
8 5 5 5 5 8 5 5 5 5 5 0 5 5 5 6 5 5 5 5 5 5
5 5 5 5 5 5 5 5 5 5 5 1 0 0 0 0 0 0 0 0 0 10
7 5 5 5 5 7 7 7 5 5 7 7 5 5 5 5 5 5 5 5 5 5